11,11
D,W,W,D,D,D,D,D,D,D,W
CS,C1,W,D,D,C5,D,D,D,C4,D
D,W,W,D,D,D,D,D,D,D,D
D,D,D,D,D,D,D,D,D,D,D
W,W,W,W,W,W,W,W,W,D,D
D,C2,D,D,D,D,D,D,W,C3,D
D,D,D,D,D,D,D,D,W,D,D
D,D,D,D,D,D,D,D,W,D,D
D,D,D,D,D,D,D,D,W,D,D
D,D,D,D,D,C6,D,D,D,D,CF
D,D,D,D,D,D,D,D,D,D,D
