8,8
0,0
0,7
7,0
-1,-1
01000100
01010101
00010101
01010101
01000101
01010101
01010101
00010001
