11,11
0,1
1,1
1,5
9,5
9,1
5,1
5,9
10,9
-1,-1
00000000000
33000300030
00000000000
00000000000
00000000000
03000000030
00000000000
00000000000
00000000000
00000300003
00000000000
